"aa" = (/obj/structure/interior_wall/apc{icon_state = "wall_4"},/turf/open/void/vehicle,/area/space)
"ab" = (/obj/structure/interior_wall/apc{icon_state = "rear_6"},/turf/open/void/vehicle,/area/space)
"ac" = (/obj/structure/interior_wall/apc{icon_state = "wheel_back_top_1"; pixel_x = -4; pixel_y = -4},/turf/open/void/vehicle,/area/space)
"ad" = (/obj/structure/interior_wall/apc{icon_state = "corner_small_L"; opacity = 0},/obj/structure/interior_wall/apc{icon_state = "wheel_back_top_2"; pixel_x = -4; pixel_y = -4},/turf/open/void/vehicle,/area/space)
"ae" = (/obj/structure/interior_wall/apc{icon_state = "wall"},/turf/open/void/vehicle,/area/space)
"af" = (/obj/structure/interior_wall/apc{icon_state = "wall_5"},/turf/open/void/vehicle,/area/space)
"ag" = (/obj/structure/interior_wall/apc{icon_state = "corner_small_R"; opacity = 0},/obj/structure/interior_wall/apc{icon_state = "wheel_front_top_2"; pixel_x = 4; pixel_y = -4},/turf/open/void/vehicle,/area/space)
"ah" = (/obj/structure/interior_wall/apc{icon_state = "wheel_front_top_3"; pixel_y = -4},/turf/open/space/basic,/area/space)
"ai" = (/obj/structure/interior_wall/apc{icon_state = "front_6"},/turf/open/void/vehicle,/area/space)
"aj" = (/obj/structure/interior_wall/apc{icon_state = "corner_small_L"},/obj/structure/interior_wall/apc{icon_state = "rear_5"},/turf/open/void/vehicle,/area/space)
"ak" = (/obj/structure/interior_wall/apc{icon_state = "wall"; opacity = 0},/turf/open/void/vehicle,/area/space)
"al" = (/obj/structure/interior_wall/apc{icon_state = "wheel_front_top_1"; pixel_x = 0; pixel_y = -4},/turf/open/void/vehicle,/area/space)
"am" = (/obj/structure/interior_wall/apc{icon_state = "corner_inverse_L_1"},/turf/open/void/vehicle,/area/space)
"an" = (/obj/structure/interior_wall/apc{icon_state = "wall"},/turf/open/space/basic,/area/space)
"ao" = (/obj/structure/interior_wall/apc{icon_state = "corner_inverse_R"; opacity = 0},/turf/open/void/vehicle,/area/space)
"ap" = (/obj/structure/interior_wall/apc{icon_state = "corner_small_R"},/obj/structure/interior_wall/apc{icon_state = "front_5"},/turf/open/void/vehicle,/area/space)
"aq" = (/obj/structure/interior_wall/apc{icon_state = "rear_4"},/turf/open/void/vehicle,/area/space)
"ar" = (/obj/structure/bed/chair/vehicle{pixel_x = -7; pixel_y = 5},/obj/structure/bed/chair/vehicle{pixel_x = 9; pixel_y = 5},/turf/open/shuttle/vehicle/med{icon_state = "floor_3"},/area/vehicle/apc)
"as" = (/obj/structure/machinery/cm_vending/sorted/vehicle_supply{pixel_y = 18},/turf/open/shuttle/vehicle{icon_state = "floor_1_7"},/area/vehicle/apc)
"at" = (/obj/structure/prop/almayer/computers/mapping_computer,/obj/structure/sign/prop3{pixel_x = -5; pixel_y = 27},/turf/open/shuttle/vehicle{icon_state = "floor_1_2"},/area/vehicle/apc)
"au" = (/obj/structure/prop/almayer/computers/sensor_computer1,/turf/open/shuttle/vehicle{icon_state = "floor_1_2"},/area/vehicle/apc)
"av" = (/obj/structure/surface/table/reinforced/prison,/obj/effect/landmark/interior/spawn/interior_viewport{dir = 8; pixel_x = 5; pixel_y = 8},/obj/item/storage/beer_pack{pixel_x = -3; pixel_y = 12},/turf/open/shuttle/vehicle{icon_state = "floor_1_8"},/area/vehicle/apc)
"aw" = (/obj/effect/landmark/interior/spawn/interior_viewport{pixel_x = -7; pixel_y = 22},/turf/open/shuttle/vehicle/med{icon_state = "dark_sterile_green_7"},/area/vehicle/apc)
"ax" = (/obj/structure/interior_wall/apc{icon_state = "front_4"},/turf/open/void/vehicle,/area/space)
"ay" = (/obj/structure/interior_wall/apc{icon_state = "rear_3"},/turf/open/void/vehicle,/area/space)
"az" = (/obj/structure/machinery/cm_vending/sorted/medical/vehicle{pixel_y = 18},/obj/structure/machinery/cm_vending/sorted/medical/blood/vehicle{pixel_x = -22; pixel_y = 18},/obj/effect/decal/medical_decals/permanent{icon_state = "triagedecaltop"; pixel_y = -2},/turf/open/shuttle/vehicle/med{icon_state = "dark_sterile_green_7"},/area/vehicle/apc)
"aA" = (/obj/effect/landmark/interior/spawn/interior_camera{dir = 10; pixel_x = -14; pixel_y = 38},/obj/effect/decal/medical_decals/permanent{icon_state = "triagedecalbottomright"},/obj/effect/decal/medical_decals/permanent{icon_state = "triagedecaltop"; pixel_y = -2},/turf/open/shuttle/vehicle/med{icon_state = "dark_sterile_green_13"},/area/vehicle/apc)
"aB" = (/turf/open/shuttle/vehicle{icon_state = "floor_1_3"},/area/vehicle/apc)
"aC" = (/turf/open/shuttle/vehicle,/area/vehicle/apc)
"aD" = (/turf/open/shuttle/vehicle{icon_state = "floor_1_14"},/area/vehicle/apc)
"aE" = (/obj/structure/bed/chair/comfy{dir = 4; pixel_y = 6},/turf/open/shuttle/vehicle,/area/vehicle/apc)
"aF" = (/obj/structure/interior_wall/apc{icon_state = "front_3"},/turf/open/void/vehicle,/area/space)
"aG" = (/obj/structure/surface/table/reinforced/prison,/obj/structure/machinery/computer/groundside_operations{dir = 8; icon_state = "comm"; pixel_y = 16},/obj/structure/machinery/computer/overwatch/almayer{dir = 4; icon_state = "overwatch"; pixel_y = 0},/obj/item/device/binoculars{pixel_x = -10; pixel_y = 10},/turf/open/shuttle/vehicle{icon_state = "floor_1_4"},/area/vehicle/apc)
"aH" = (/obj/effect/landmark/interior/spawn/telephone{pixel_x = 5; pixel_y = 30},/obj/structure/extinguisher_cabinet/lifeboat{icon = 'icons/obj/vehicles/interiors/general.dmi'; pixel_x = -8; pixel_y = 28},/obj/effect/landmark/interior/spawn/vehicle_gunner_seat/armor{dir = 4},/turf/open/shuttle/vehicle{icon_state = "floor_3_13"},/area/vehicle/apc)
"aI" = (/obj/effect/landmark/interior/spawn/weapons_loader,/obj/structure/sign/poster/propaganda{pixel_x = 9; pixel_y = 29},/turf/open/shuttle/vehicle{icon_state = "floor_3_5"},/area/vehicle/apc)
"aJ" = (/obj/effect/landmark/interior/spawn/vehicle_driver_seat/armor{dir = 4},/obj/structure/vehicle_locker{layer = 5.21; pixel_y = 28},/turf/open/shuttle/vehicle{icon_state = "floor_3_8_1"},/area/vehicle/apc)
"aK" = (/obj/structure/machinery/optable,/turf/open/shuttle/vehicle/med,/area/vehicle/apc)
"aL" = (/obj/effect/decal/medical_decals/permanent{icon_state = "docdecal1"; pixel_x = -5; pixel_y = 16},/turf/open/shuttle/vehicle/med,/area/vehicle/apc)
"aM" = (/obj/structure/interior_wall/apc{icon_state = "front_2"},/turf/open/void/vehicle,/area/space)
"aN" = (/obj/structure/interior_wall/apc{icon_state = "rear_1"},/turf/open/void/vehicle,/area/space)
"aO" = (/obj/structure/interior_wall/apc{icon_state = "rear_wheel_L"},/turf/open/void/vehicle,/area/space)
"aP" = (/obj/structure/interior_wall/apc{icon_state = "rear_wheel_R"; opacity = 0},/turf/open/void/vehicle,/area/space)
"aQ" = (/obj/effect/decal/medical_decals/permanent{dir = 4; icon_state = "triagedecaldir"},/obj/structure/bed/chair/vehicle{dir = 8; icon_state = "vehicle_seat"; pixel_x = 6; pixel_y = 6},/turf/open/shuttle/vehicle/med{icon_state = "dark_sterile_green_8"},/area/vehicle/apc)
"aR" = (/obj/structure/surface/table/reinforced/prison,/obj/structure/machinery/prop/almayer/CICmap{pixel_y = 5},/turf/open/shuttle/vehicle{icon_state = "floor_1_3"},/area/vehicle/apc)
"aS" = (/obj/structure/interior_wall/apc{icon_state = "front_wheel_L"; opacity = 0},/turf/open/void/vehicle,/area/space)
"aT" = (/obj/structure/interior_wall/apc{icon_state = "front_wheel_R"},/turf/open/void/vehicle,/area/space)
"aU" = (/obj/structure/interior_wall/apc{icon_state = "front_1"},/turf/open/void/vehicle,/area/space)
"aV" = (/turf/open/void/vehicle,/area/space)
"aW" = (/obj/structure/interior_wall/apc{alpha = 100; icon_state = "wall_door_front"; layer = 5.2; pixel_y = 32},/turf/open/void/vehicle,/area/space)
"aX" = (/obj/structure/interior_wall/apc{alpha = 100; icon_state = "door_front"; layer = 5.2; pixel_y = 32},/turf/open/void/vehicle,/area/space)
"aY" = (/turf/open/shuttle/vehicle{icon_state = "floor_1_5"},/area/vehicle/apc)
"aZ" = (/obj/structure/surface/table/reinforced/prison,/obj/item/ammo_box/magazine/misc/mre{pixel_x = -7; pixel_y = 15},/obj/item/ammo_box/rounds/ap,/turf/open/shuttle/vehicle,/area/vehicle/apc)
"ba" = (/obj/structure/interior_wall/apc{alpha = 100; icon_state = "wall"; layer = 5.2; pixel_y = 32},/turf/open/void/vehicle,/area/space)
"bb" = (/turf/open/shuttle/vehicle{icon_state = "floor_1_4"},/area/vehicle/apc)
"bc" = (/turf/open/shuttle/vehicle{icon_state = "floor_3_6"},/area/vehicle/apc)
"bd" = (/obj/structure/interior_wall/apc{icon_state = "door_rear_center"},/turf/open/void/vehicle,/area/space)
"be" = (/obj/structure/surface/table/reinforced/prison,/obj/structure/machinery/recharger{pixel_y = 8},/obj/item/device/defibrillator,/turf/open/shuttle/vehicle/med{icon_state = "dark_sterile_green_5"},/area/vehicle/apc)
"bf" = (/obj/effect/decal/medical_decals/permanent{icon_state = "triagedecalbottom"},/obj/effect/decal/medical_decals/permanent{icon_state = "docdecal2"; pixel_x = -5; pixel_y = 16},/obj/structure/machinery/iv_drip,/turf/open/shuttle/vehicle/med{icon_state = "dark_sterile_green_5"},/area/vehicle/apc)
"bg" = (/obj/effect/decal/medical_decals/permanent{icon_state = "triagedecaltopright"},/obj/effect/decal/medical_decals/permanent{icon_state = "triagedecalbottom"},/turf/open/shuttle/vehicle/med{icon_state = "dark_sterile_green_14"},/area/vehicle/apc)
"bh" = (/turf/open/shuttle/vehicle{icon_state = "floor_3_7_1"},/area/vehicle/apc)
"bi" = (/obj/effect/landmark/interior/spawn/vehicle_support_gunner_seat/second,/obj/structure/prop/vehicle/firing_port_weapon,/turf/open/shuttle/vehicle{icon_state = "floor_1_10"},/area/vehicle/apc)
"bj" = (/obj/structure/bed/chair/vehicle{dir = 1; pixel_x = 8},/obj/structure/bed/chair/vehicle{dir = 1; pixel_x = -8},/turf/open/shuttle/vehicle{icon_state = "floor_3_5"},/area/vehicle/apc)
"bk" = (/obj/structure/bed/chair/vehicle{dir = 1; pixel_x = 8},/obj/structure/bed/chair/vehicle{dir = 1; pixel_x = -8},/turf/open/shuttle/vehicle{icon_state = "floor_3_9_1"},/area/vehicle/apc)
"bl" = (/obj/structure/bed/chair/vehicle{dir = 1; pixel_x = -7},/obj/structure/bed/chair/vehicle{dir = 1; pixel_x = 8},/turf/open/shuttle/vehicle/med{icon_state = "floor_3"},/area/vehicle/apc)
"bm" = (/obj/structure/bed/chair/vehicle{dir = 1; pixel_x = 8},/obj/structure/bed/chair/vehicle{dir = 1; pixel_x = -7},/turf/open/shuttle/vehicle{icon_state = "floor_1_1"},/area/vehicle/apc)
"bn" = (/obj/effect/landmark/interior/spawn/entrance{alpha = 50; exit_type = /obj/structure/interior_exit/vehicle/apc; name = "Right APC door"; tag = "right"},/turf/open/shuttle/vehicle{icon_state = "floor_1_1"},/area/vehicle/apc)
"bo" = (/obj/structure/bed/chair/vehicle{dir = 1; pixel_x = 8},/obj/structure/bed/chair/vehicle{dir = 1; pixel_x = -7},/turf/open/shuttle/vehicle{icon_state = "floor_1_9"},/area/vehicle/apc)
"bp" = (/obj/structure/prop/vehicle/sensor_equipment,/obj/effect/landmark/interior/spawn/interior_viewport{dir = 8; pixel_x = 5; pixel_y = 8},/turf/open/shuttle/vehicle{icon_state = "floor_3_12"},/area/vehicle/apc)

(1,1,1) = {"
abacadaaaeaeafaeagahalai
ajakamarasatauavaoanakap
aqawazaAaBaCaEaGaHaIaJax
ayaKaLaQaRaZaCaCaYaDbcaF
bdbebfbgaBaCaCbbbhbjbkaM
aNaOaPblbibnbmbobpaSaTaU
aVaVaVbaaWaXbababaaVaVaV
"}
