"aa" = (/turf/open/void,/area/space)
"ab" = (/turf/closed/wall/rock,/area/space)
"ac" = (/turf/closed/wall/wood,/area/space)
"ad" = (/turf/closed/wall/strata_outpost,/area/space)
"ae" = (/turf/open/auto_turf/shale/layer1,/area/space)
"af" = (/obj/effect/decal/cleanable/dirt,/obj/structure/largecrate/guns/russian,/obj/item/storage/donut_box/empty{pixel_x = 1; pixel_y = 12},/turf/open/auto_turf/shale/layer1,/area/space)
"ag" = (/obj/structure/reagent_dispensers/beerkeg/alt_dark{pixel_y = 11},/obj/structure/reagent_dispensers/beerkeg/alt_dark{pixel_x = 9},/obj/structure/flora/pottedplant{icon_state = "pottedplant_29"; pixel_x = -4; pixel_y = -6},/turf/open/floor/strata{icon_state = "fake_wood"},/area/space)
"ah" = (/obj/effect/decal/cleanable/dirt,/obj/structure/bed/roller,/obj/item/bedsheet/brown,/turf/open/floor/plating,/area/space)
"ai" = (/obj/structure/safe{tumbler_1_open = 58; tumbler_2_open = 32},/obj/item/tool/lighter/zippo/gold,/obj/item/storage/fancy/cigar,/obj/item/spacecash/c500,/obj/item/spacecash/c50,/obj/item/coin/gold,/obj/item/weapon/gun/pistol/highpower,/obj/item/ammo_magazine/pistol/highpower,/obj/item/ammo_magazine/pistol/highpower,/turf/open/floor/plating,/area/space)
"aj" = (/obj/effect/decal/cleanable/dirt,/turf/open/auto_turf/shale/layer2,/area/space)
"ak" = (/obj/effect/decal/cleanable/dirt,/turf/open/floor/strata{icon_state = "fake_wood"},/area/space)
"al" = (/obj/structure/curtain/red,/turf/open/floor/strata{icon_state = "fake_wood"},/area/space)
"am" = (/turf/open/floor/strata{icon_state = "fake_wood"},/area/space)
"an" = (/turf/open/floor/plating,/area/space)
"ao" = (/obj/effect/decal/cleanable/dirt,/obj/structure/prop/ice_colony/tiger_rug{desc = "A beat up beer stained, incredibly garish, polyester tiger rug. No one knows how it got here. Written on the wash tag are the words 'From Thedus, with love <3', in Sharpie."; icon_state = "HotlineAlt"; layer = 2.9; name = "Richard the tiger"},/turf/open/floor/plating,/area/space)
"ap" = (/obj/structure/machinery/light/small{dir = 4},/turf/open/floor/plating,/area/space)
"aq" = (/obj/effect/decal/cleanable/dirt,/obj/structure/surface/table/woodentable/poor,/obj/structure/prop/ice_colony/hula_girl{pixel_y = 11},/obj/item/tool/hand_labeler,/obj/item/paper_bin{pixel_x = 7; pixel_y = 7},/turf/open/floor/strata{icon_state = "fake_wood"},/area/space)
"ar" = (/obj/structure/surface/table/woodentable/poor,/obj/item/tool/pen,/obj/item/storage/wallet,/turf/open/floor/strata{icon_state = "fake_wood"},/area/space)
"as" = (/obj/structure/machinery/light/small{dir = 8; pixel_x = -11; pixel_y = 10},/turf/open/floor/strata{icon_state = "fake_wood"},/area/space)
"at" = (/obj/structure/bed/chair/office/dark{dir = 8},/turf/open/floor/strata{icon_state = "fake_wood"},/area/space)
"au" = (/obj/structure/machinery/light/small{dir = 1; pixel_x = -3; pixel_y = 20},/obj/structure/largecrate/random/secure,/turf/open/floor/strata{icon_state = "fake_wood"},/area/space)
"av" = (/obj/structure/surface/rack,/turf/open/floor/strata{icon_state = "fake_wood"},/area/space)
"aw" = (/obj/effect/decal/cleanable/dirt,/obj/structure/surface/rack,/obj/structure/sign/poster{desc = "It says DRUG."; icon_state = "poster2"; pixel_y = 30},/turf/open/floor/strata{icon_state = "fake_wood"},/area/space)
"ax" = (/obj/effect/decal/cleanable/dirt,/obj/structure/reagent_dispensers/water_cooler/stacks{pixel_y = 9},/turf/open/floor/plating,/area/space)
"ay" = (/obj/structure/machinery/power/port_gen/pacman,/obj/structure/cable{icon_state = "0-2"},/turf/open/floor/strata{icon_state = "green3"; dir = 1},/area/space)
"az" = (/obj/structure/machinery/power/apc{dir = 1; pixel_y = 24},/obj/structure/cable{icon_state = "0-2"},/turf/open/floor/strata{icon_state = "green3"; dir = 1},/area/space)
"aA" = (/obj/structure/sign/poster{desc = "This poster features Audrey Rainwater standing in a jacuzzi. She was the July 2182 centerfold in House Bunny Gentleman's Magazine. Don't ask how you know that."; icon_state = "poster16"; layer = 3.3; name = "'Miss July' Pinup"; pixel_y = 29; serial_number = 16},/obj/structure/sign/poster{desc = "One of those hot, tanned babes back the beaches of good ol' Earth."; icon_state = "poster12"; name = "Beach Babe Pinup"; pixel_x = 11; pixel_y = 29; serial_number = 12},/turf/open/floor/plating,/area/space)
"aB" = (/obj/structure/machinery/space_heater/radiator/red{pixel_y = 15},/turf/open/floor/plating,/area/space)
"aC" = (/obj/item/tool/pickaxe/silver,/turf/open/auto_turf/shale/layer1,/area/space)
"aD" = (/turf/open/auto_turf/shale/layer2,/area/space)
"aE" = (/obj/structure/largecrate/merc/clothing,/turf/open/auto_turf/shale/layer1,/area/space)
"aF" = (/obj/structure/machinery/autolathe/full{pixel_y = 5},/turf/open/floor/strata{icon_state = "fake_wood"},/area/space)
"aG" = (/obj/effect/decal/cleanable/dirt,/obj/effect/decal/cleanable/dirt,/turf/open/floor/strata{icon_state = "fake_wood"},/area/space)
"aH" = (/obj/effect/decal/cleanable/dirt,/turf/open/floor/plating,/area/space)
"aI" = (/obj/effect/decal/cleanable/dirt,/obj/structure/cable{icon_state = "1-4"},/turf/open/floor/strata{icon_state = "green3"},/area/space)
"aJ" = (/obj/effect/decal/cleanable/generic,/obj/structure/cable{icon_state = "1-8"},/turf/open/floor/strata{icon_state = "green3"; dir = 10},/area/space)
"aK" = (/obj/structure/platform/strata/metal{dir = 4},/turf/open/gm/river,/area/space)
"aL" = (/obj/effect/decal/cleanable/generic,/obj/structure/pipes/standard/simple/hidden/supply,/turf/open/floor/strata{dir = 4; icon_state = "floor3"},/area/space)
"aM" = (/obj/effect/decal/cleanable/dirt,/turf/open/floor/plating/plating_catwalk/strata,/area/space)
"aN" = (/obj/structure/surface/table/gamblingtable,/turf/open/floor/strata{icon_state = "green3"; dir = 8},/area/space)
"aO" = (/obj/structure/surface/table/gamblingtable,/obj/item/tool/candle{icon_state = "candle2"; pixel_x = -8; pixel_y = -9},/turf/open/floor/plating,/area/space)
"aP" = (/obj/structure/surface/table/gamblingtable,/obj/structure/largecrate/random/mini/wooden{pixel_y = 4},/turf/open/floor/strata{icon_state = "fake_wood"},/area/space)
"aQ" = (/obj/structure/machinery/light/small{dir = 4},/turf/open/auto_turf/shale/layer1,/area/space)
"aR" = (/obj/structure/bed/roller,/obj/item/bedsheet/brown,/turf/open/auto_turf/shale/layer1,/area/space)
"aS" = (/turf/open/floor/plating/plating_catwalk/strata,/area/space)
"aT" = (/obj/structure/girder/displaced,/turf/open/auto_turf/shale/layer1,/area/space)
"aU" = (/obj/structure/bed/chair/wood/normal{dir = 4},/turf/open/floor/strata{icon_state = "green3"; dir = 8},/area/space)
"aV" = (/obj/structure/surface/table/gamblingtable,/obj/item/toy/deck,/turf/open/floor/plating,/area/space)
"aW" = (/obj/structure/bed/chair/wood/normal{dir = 8; tag = ""},/turf/open/floor/plating,/area/space)
"aX" = (/obj/structure/machinery/light/small,/obj/structure/machinery/computer/arcade,/turf/open/floor/strata,/area/space)
"aY" = (/obj/structure/machinery/computer/arcade,/turf/open/floor/strata,/area/space)
"aZ" = (/obj/structure/surface/table/gamblingtable,/turf/open/floor/plating,/area/space)
"ba" = (/obj/structure/girder/displaced,/turf/open/floor/plating,/area/space)
"bb" = (/obj/structure/girder,/turf/open/floor/plating,/area/space)
"bc" = (/obj/structure/bed/roller,/obj/item/bedsheet/brown,/turf/open/floor/plating,/area/space)
"bd" = (/obj/structure/pipes/standard/simple/hidden/supply,/turf/open/floor/plating/plating_catwalk/strata,/area/space)
"be" = (/obj/structure/surface/rack,/turf/open/auto_turf/shale/layer1,/area/space)
"bf" = (/obj/item/device/flashlight/lamp/tripod,/turf/open/auto_turf/shale/layer1,/area/space)
"bg" = (/obj/effect/decal/cleanable/dirt,/obj/structure/machinery/computer/arcade,/turf/open/floor/plating,/area/space)
"bh" = (/turf/open/floor/strata{icon_state = "green3"; dir = 4},/area/space)
"bi" = (/obj/structure/bed/chair/wood/normal{dir = 4},/turf/open/floor/plating,/area/space)
"bj" = (/obj/structure/surface/table/gamblingtable,/obj/item/weapon/melee/baseballbat/metal,/obj/item/weapon/melee/baseballbat/metal{pixel_y = 6},/turf/open/floor/plating,/area/space)
"bk" = (/obj/structure/bed/chair/wood/normal{dir = 8; tag = ""},/turf/open/floor/strata,/area/space)
"bl" = (/turf/open/floor/strata,/area/space)
"bm" = (/obj/structure/bed/chair/wood/normal{dir = 8; tag = ""},/turf/open/floor/strata{icon_state = "green3"; dir = 4},/area/space)
"bn" = (/obj/effect/decal/cleanable/dirt,/obj/structure/pipes/standard/simple/hidden/supply,/turf/open/floor/plating/plating_catwalk/strata,/area/space)
"bo" = (/obj/item/tool/pickaxe/jackhammer{pixel_y = 10},/turf/open/auto_turf/shale/layer1,/area/space)
"bp" = (/obj/effect/decal/cleanable/dirt,/obj/structure/closet/crate/miningcar/yellow,/turf/open/floor/strata{icon_state = "fake_wood"},/area/space)
"bq" = (/obj/effect/decal/cleanable/dirt,/turf/open/floor/strata,/area/space)
"br" = (/obj/effect/decal/cleanable/dirt,/obj/item/device/flashlight/lamp/tripod,/turf/open/floor/strata,/area/space)
"bs" = (/obj/structure/surface/table/gamblingtable,/obj/structure/closet/crate{pixel_y = 8},/obj/item/tool/extinguisher/mini,/turf/open/floor/strata{icon_state = "fake_wood"},/area/space)
"bt" = (/obj/structure/surface/table/gamblingtable,/obj/structure/machinery/light/small{dir = 4},/turf/open/floor/strata{icon_state = "fake_wood"},/area/space)
"bu" = (/obj/effect/decal/cleanable/dirt,/obj/structure/pipes/standard/simple/hidden/supply,/turf/open/floor/strata{dir = 4; icon_state = "floor3"},/area/space)
"bv" = (/obj/effect/decal/cleanable/dirt,/turf/open/auto_turf/shale/layer1,/area/space)
"bw" = (/obj/structure/machinery/light/small,/turf/open/floor/strata,/area/space)
"bx" = (/turf/open/floor/strata{icon_state = "green3"; dir = 5},/area/space)
"by" = (/turf/open/floor/strata{icon_state = "green3"; dir = 1},/area/space)
"bz" = (/obj/effect/decal/cleanable/dirt,/obj/effect/decal/cleanable/dirt,/obj/structure/pipes/standard/simple/hidden/supply,/turf/open/floor/strata{dir = 4; icon_state = "floor3"},/area/space)
"bA" = (/obj/structure/pipes/vents/pump,/turf/open/floor/strata,/area/space)
"bB" = (/turf/open/floor/strata{icon_state = "green3"},/area/space)
"bC" = (/obj/structure/bed/chair/wood/normal{dir = 1; tag = "icon-wooden_chair (NORTH)"},/turf/open/floor/strata{icon_state = "green3"},/area/space)
"bD" = (/turf/open/floor/strata{icon_state = "green4"; dir = 8},/area/space)
"bE" = (/obj/structure/inflatable/door,/turf/open/floor/strata,/area/space)
"bF" = (/obj/effect/decal/cleanable/dirt,/obj/structure/machinery/light/small{dir = 4},/obj/structure/pipes/standard/simple/hidden/supply,/turf/open/floor/plating/plating_catwalk/strata,/area/space)
"bG" = (/obj/structure/pipes/standard/simple/hidden/supply{dir = 6; tag = "icon-intact-supply (EAST)"},/turf/open/floor/strata{icon_state = "green3"; dir = 9},/area/space)
"bH" = (/turf/open/floor/strata{dir = 4; icon_state = "floor3"},/area/space)
"bI" = (/obj/effect/decal/cleanable/dirt,/obj/structure/curtain/red,/turf/open/floor/strata{icon_state = "fake_wood"},/area/space)
"bJ" = (/obj/structure/curtain/red,/turf/open/floor/strata,/area/space)
"bK" = (/obj/structure/largecrate/random/barrel/blue,/turf/open/floor/strata{icon_state = "green3"; dir = 4},/area/space)
"bL" = (/obj/structure/sink{dir = 8; pixel_x = -12; pixel_y = 2},/turf/open/floor/strata{icon_state = "multi_tiles"},/area/space)
"bM" = (/obj/structure/machinery/light/small,/obj/structure/pipes/standard/simple/hidden/supply{dir = 4; tag = "icon-intact-supply (EAST)"},/turf/open/floor/strata{icon_state = "green3"; dir = 6},/area/space)
"bN" = (/obj/effect/decal/cleanable/dirt,/obj/structure/sign/poster{icon_state = "poster14"; pixel_y = 32},/turf/open/floor/strata{icon_state = "cyan3"; dir = 1},/area/space)
"bO" = (/obj/effect/decal/cleanable/dirt,/turf/closed/wall/strata_outpost,/area/space)
"bP" = (/obj/structure/window/reinforced/tinted,/obj/structure/toilet{dir = 4; pixel_y = 8},/turf/open/floor/strata{icon_state = "multi_tiles"},/area/space)
"bQ" = (/obj/effect/decal/cleanable/dirt,/obj/effect/decal/cleanable/cobweb2,/obj/structure/machinery/door/window/tinted{dir = 2},/turf/open/floor/strata{icon_state = "multi_tiles"},/area/space)
"bR" = (/turf/open/floor/strata{icon_state = "green3"; dir = 8},/area/space)
"bS" = (/obj/effect/decal/cleanable/dirt,/obj/structure/coatrack,/turf/open/floor/strata,/area/space)
"bT" = (/obj/effect/decal/cleanable/dirt,/obj/structure/largecrate/random/barrel/white{pixel_x = -6; pixel_y = 11},/turf/open/floor/plating,/area/space)
"bU" = (/obj/effect/decal/cleanable/dirt,/obj/structure/sink{dir = 8; pixel_x = -12; pixel_y = 2},/turf/open/floor/strata{icon_state = "multi_tiles"},/area/space)
"bV" = (/turf/open/floor/strata{dir = 8; icon_state = "cyan3"},/area/space)
"bW" = (/obj/structure/machinery/power/apc{dir = 4},/turf/open/floor/strata,/area/space)
"bX" = (/turf/open/floor/strata{icon_state = "cyan4"; dir = 2},/area/space)
"bY" = (/turf/open/floor/strata{icon_state = "cyan4"; dir = 1},/area/space)
"bZ" = (/obj/effect/decal/cleanable/generic,/obj/structure/bed/chair/wood/normal{dir = 4},/turf/open/floor/strata{icon_state = "green3"; dir = 8},/area/space)
"ca" = (/obj/effect/decal/cleanable/dirt,/obj/structure/surface/table/gamblingtable,/obj/item/toy/deck{pixel_x = 8},/turf/open/floor/plating/plating_catwalk/strata,/area/space)
"cb" = (/obj/structure/largecrate/random/case,/turf/open/floor/strata,/area/space)
"cc" = (/obj/structure/coatrack,/turf/open/floor/strata,/area/space)
"cd" = (/obj/structure/machinery/door/airlock/strata/autoname,/turf/open/floor/plating/plating_catwalk/strata,/area/space)
"ce" = (/obj/effect/decal/cleanable/dirt,/obj/structure/machinery/light/small{dir = 4},/turf/open/floor/strata{dir = 4; icon_state = "cyan3"},/area/space)
"cf" = (/obj/structure/bed/chair/wood/normal{dir = 4},/turf/open/floor/strata{icon_state = "green4"; dir = 4},/area/space)
"cg" = (/obj/structure/surface/table/gamblingtable,/obj/structure/machinery/light/small,/turf/open/floor/strata{icon_state = "green3"},/area/space)
"ch" = (/obj/effect/decal/cleanable/dirt,/obj/structure/bed/chair/wood/normal{dir = 8; tag = ""},/turf/open/floor/strata{icon_state = "green3"},/area/space)
"ci" = (/obj/structure/largecrate/random/case/double{pixel_y = 8},/obj/structure/largecrate/random/case/small,/turf/open/floor/strata{icon_state = "green3"},/area/space)
"cj" = (/obj/structure/machinery/light/small,/turf/open/floor/plating,/area/space)
"ck" = (/obj/structure/pipes/standard/manifold/hidden/supply,/turf/open/floor/strata{icon_state = "green3"},/area/space)
"cl" = (/obj/structure/machinery/light/small,/turf/open/floor/strata{dir = 8; icon_state = "cyan3"},/area/space)
"cm" = (/obj/structure/surface/table/almayer,/turf/open/floor/strata,/area/space)
"cn" = (/turf/open/floor/strata{dir = 4; icon_state = "cyan4"},/area/space)
"co" = (/obj/structure/machinery/disposal,/turf/open/floor/strata{icon_state = "cyan4"; dir = 8},/area/space)
"cp" = (/obj/structure/platform/strata/metal{dir = 4},/obj/structure/platform/strata/metal,/turf/open/gm/river,/area/space)
"cq" = (/obj/structure/machinery/door/airlock/strata/autoname{dir = 1},/turf/open/floor/strata{dir = 6; icon_state = "multi_tiles"},/area/space)
"cr" = (/obj/structure/pipes/standard/simple/hidden/supply{dir = 4; tag = "icon-intact-supply (EAST)"},/turf/open/floor/strata{icon_state = "green3"},/area/space)
"cs" = (/obj/structure/pipes/standard/simple/hidden/supply{dir = 10; tag = "icon-intact-supply (EAST)"},/turf/open/floor/strata{icon_state = "green3"},/area/space)
"ct" = (/obj/structure/platform/strata/metal{dir = 1},/turf/open/gm/river,/area/space)
"cu" = (/obj/structure/platform/strata/metal{dir = 1},/obj/structure/platform/strata/metal{dir = 4},/turf/open/gm/river,/area/space)
"cv" = (/obj/structure/platform/strata/metal{dir = 1},/obj/structure/platform/strata/metal{dir = 8},/obj/structure/platform/strata/metal,/turf/open/gm/river,/area/space)
"cw" = (/obj/structure/platform/strata/metal{dir = 1},/obj/structure/platform_decoration/strata/metal{dir = 1},/turf/open/gm/river,/area/space)
"cx" = (/obj/structure/platform/strata/metal{dir = 1},/obj/structure/platform{dir = 4},/turf/open/gm/river,/area/space)
"cy" = (/obj/structure/platform/strata/metal{dir = 1},/obj/structure/platform{dir = 8},/turf/open/gm/river,/area/space)
"cz" = (/obj/structure/platform/strata/metal{dir = 1},/obj/structure/platform_decoration/strata/metal,/turf/open/gm/river,/area/space)
"cA" = (/obj/structure/platform/strata/metal{dir = 1},/obj/structure/platform/strata/metal{dir = 4},/obj/structure/platform/strata/metal,/turf/open/gm/river,/area/space)
"cB" = (/obj/structure/platform/strata/metal{dir = 1},/obj/structure/platform/strata/metal{dir = 8},/turf/open/gm/river,/area/space)
"cC" = (/obj/structure/machinery/light/small,/turf/open/floor/plating/plating_catwalk/strata,/area/space)
"cD" = (/obj/structure/platform/strata/metal{dir = 8},/obj/structure/platform/strata/metal,/turf/open/gm/river,/area/space)
"cE" = (/obj/structure/platform/strata/metal,/obj/structure/platform{dir = 4},/turf/open/gm/river,/area/space)
"cF" = (/obj/structure/platform/strata/metal,/obj/structure/platform{dir = 8},/turf/open/gm/river,/area/space)
"cG" = (/obj/effect/decal/cleanable/dirt,/obj/structure/ladder,/turf/open/floor/plating/plating_catwalk/strata,/area/space)
"cH" = (/obj/effect/decal/cleanable/generic,/obj/effect/decal/cleanable/dirt,/turf/open/floor/strata{dir = 4; icon_state = "floor3"},/area/space)
"cI" = (/obj/effect/decal/cleanable/dirt,/obj/structure/machinery/space_heater/radiator/red{pixel_y = 15},/turf/open/floor/strata{icon_state = "multi_tiles"},/area/space)
"cJ" = (/obj/structure/inflatable/popped/door,/obj/structure/pipes/standard/simple/hidden/supply,/turf/open/floor/strata,/area/space)
"cK" = (/obj/structure/surface/rack,/obj/structure/machinery/light/small{dir = 4},/turf/open/floor/plating/plating_catwalk/strata,/area/space)
"cL" = (/obj/structure/sign/poster{desc = "YOU ALWAYS KNOW A WORKING JOE. YOU ALWAYS KNOW A WORKING JOE. YOU ALWAYS KNOW A WORKING JOE. YOU ALWAYS KNOW A WORKING JOE. YOU ALWAYS KNOW A WORKING JOE."; icon_state = "poster11"; name = "YOU ALWAYS KNOW A WORKING JOE."; pixel_x = -22; pixel_y = 3; serial_number = 11},/obj/structure/closet/toolcloset,/turf/open/floor/greengrid,/area/space)
"cM" = (/turf/open/floor/greengrid,/area/space)
"cN" = (/obj/structure/machinery/door/airlock/strata/autoname{dir = 1},/obj/structure/pipes/standard/simple/hidden/supply,/turf/open/floor/plating/plating_catwalk/strata,/area/space)
"cO" = (/obj/effect/decal/cleanable/dirt,/obj/effect/decal/cleanable/dirt,/obj/structure/surface/table/almayer,/obj/structure/machinery/light/small{dir = 8; pixel_x = -11; pixel_y = 10},/obj/item/device/flashlight/lamp,/turf/open/floor/plating/plating_catwalk/strata,/area/space)
"cP" = (/obj/structure/surface/rack,/turf/open/floor/strata{icon_state = "multi_tiles"},/area/space)
"cQ" = (/obj/structure/surface/table/almayer,/obj/item/toy/deck/uno{pixel_x = 7; pixel_y = 5},/turf/open/floor/plating/plating_catwalk/strata,/area/space)
"cR" = (/obj/structure/pipes/standard/simple/hidden/supply,/turf/open/floor/strata{dir = 4; icon_state = "floor3"},/area/space)
"cS" = (/obj/structure/pipes/standard/simple/hidden/supply,/turf/open/floor/strata,/area/space)
"cT" = (/obj/effect/decal/cleanable/dirt,/obj/structure/pipes/standard/simple/hidden/supply,/turf/open/floor/strata{icon_state = "cyan4"; dir = 2},/area/space)
"cU" = (/obj/structure/pipes/standard/simple/hidden/supply,/turf/open/floor/strata{dir = 8; icon_state = "cyan3"},/area/space)
"cV" = (/obj/structure/pipes/standard/simple/hidden/supply,/turf/open/floor/plating,/area/space)
"cW" = (/obj/structure/pipes/standard/simple/hidden/supply{dir = 5; tag = "icon-intact-supply (NORTHEAST)"},/turf/open/floor/strata{dir = 8; icon_state = "cyan3"},/area/space)
"cX" = (/obj/effect/decal/cleanable/dirt,/obj/structure/pipes/standard/simple/hidden/supply,/turf/open/floor/strata{icon_state = "green3"},/area/space)
"cY" = (/obj/structure/machinery/door/airlock/strata/autoname{dir = 1},/obj/structure/pipes/standard/simple/hidden/supply,/turf/open/floor/strata{dir = 6; icon_state = "multi_tiles"},/area/space)
"cZ" = (/obj/effect/decal/cleanable/dirt,/obj/structure/pipes/standard/simple/hidden/supply{dir = 4; tag = "icon-intact-supply (EAST)"},/turf/open/floor/plating/plating_catwalk/strata,/area/space)
"da" = (/obj/structure/pipes/standard/simple/hidden/supply{dir = 4; tag = "icon-intact-supply (EAST)"},/turf/open/floor/plating/plating_catwalk/strata,/area/space)
"db" = (/obj/structure/pipes/standard/simple/hidden/supply{dir = 4; tag = "icon-intact-supply (EAST)"},/turf/open/floor/strata{dir = 4; icon_state = "floor3"},/area/space)
"dc" = (/obj/structure/pipes/standard/manifold/hidden/supply,/turf/open/floor/strata{dir = 4; icon_state = "floor3"},/area/space)
"dd" = (/obj/effect/decal/cleanable/dirt,/obj/effect/decal/cleanable/dirt,/obj/structure/pipes/standard/simple/hidden/supply{dir = 4; tag = "icon-intact-supply (EAST)"},/turf/open/floor/strata{dir = 4; icon_state = "floor3"},/area/space)
"de" = (/obj/effect/decal/cleanable/dirt,/obj/structure/machinery/light/small{dir = 1; pixel_x = -3; pixel_y = 20},/obj/structure/pipes/standard/simple/hidden/supply{dir = 4; tag = "icon-intact-supply (EAST)"},/turf/open/floor/plating/plating_catwalk/strata,/area/space)
"df" = (/obj/effect/decal/cleanable/dirt,/obj/structure/pipes/standard/simple/hidden/supply{dir = 4; tag = "icon-intact-supply (EAST)"},/turf/open/floor/strata{dir = 4; icon_state = "floor3"},/area/space)
"dg" = (/obj/structure/pipes/standard/manifold/hidden/supply,/turf/open/floor/plating/plating_catwalk/strata,/area/space)
"dh" = (/obj/effect/decal/cleanable/dirt,/obj/structure/pipes/standard/manifold/hidden/supply{dir = 1; tag = "icon-map-supply (EAST)"},/turf/open/floor/plating/plating_catwalk/strata,/area/space)
"di" = (/obj/structure/machinery/light/small{dir = 1; pixel_x = -3; pixel_y = 20},/obj/structure/pipes/standard/simple/hidden/supply{dir = 4; tag = "icon-intact-supply (EAST)"},/turf/open/floor/plating/plating_catwalk/strata,/area/space)
"dj" = (/obj/structure/pipes/standard/simple/hidden/supply,/turf/open/floor/strata{icon_state = "multi_tiles"},/area/space)
"dk" = (/obj/structure/pipes/standard/simple/hidden/supply{dir = 6; tag = "icon-intact-supply (EAST)"},/turf/open/floor/plating/plating_catwalk/strata,/area/space)
"dl" = (/obj/item/device/flashlight/on{layer = 2.7; pixel_y = -21},/obj/structure/pipes/standard/simple/hidden/supply{dir = 9; tag = "icon-intact-supply (NORTHWEST)"},/turf/open/floor/plating/plating_catwalk/strata,/area/space)
"dm" = (/obj/structure/surface/rack,/obj/structure/pipes/vents/pump,/turf/open/floor/strata{icon_state = "multi_tiles"},/area/space)

(1,1,1) = {"
aaaaaaaaaaaaaaaaaaaaaaaaaaaaaaaaaaaaaaaaaaaaaaaaaaaaaaaaaaaaaaaaaaaaaaaaaaaaaaaaaaaaaaaaaaaaaaaaaaaa
aaaaaaaaaaaaaaaaaaaaaaaaaaaaaaaaaaaaaaaaaaaaaaaaaaaaaaaaaaaaaaaaaaaaaaaaaaaaaaaaaaaaaaaaaaaaaaaaaaaa
aaaaaaaaaaaaaaaaaaaaaaaaaaaaaaaaaaaaaaaaaaaaaaaaaaaaaaaaaaaaaaaaaaaaaaaaaaaaaaaaaaaaaaaaaaaaaaaaaaaa
aaaaaaaaaaaaaaaaaaaaaaaaaaaaaaaaaaaaaaaaaaaaaaaaaaaaaaaaaaaaaaaaaaaaaaaaaaaaaaaaaaaaaaaaaaaaaaaaaaaa
aaaaaaaaaaaaaaaaaaaaaaaaaaaaaaaaaaaaaaaaaaaaaaaaaaaaaaaaaaaaaaaaaaaaaaaaaaaaaaaaaaaaaaaaaaaaaaaaaaaa
aaaaaaaaaaaaaaaaaaaaaaaaaaaaaaaaaaaaaaaaaaaaaaaaaaaaaaaaaaaaaaaaaaaaaaaaaaaaaaaaaaaaaaaaaaaaaaaaaaaa
aaaaaaaaaaaaaaaaaaaaaaaaaaaaaaaaaaaaaaaaaaaaaaaaaaaaaaaaaaaaaaaaaaaaaaaaaaaaaaaaaaaaaaaaaaaaaaaaaaaa
aaaaaaaaaaaaaaaaaaaaaaaaaaaaaaaaaaaaaaaaaaaaaaaaaaaaaaaaaaaaaaaaaaaaaaaaaaaaaaaaaaaaaaaaaaaaaaaaaaaa
aaaaaaaaaaaaaaaaaaaaaaaaaaaaaaaaaaababacadadadadadaaaaaaaaaaaaaaaaaaaaaaaaaaaaaaaaaaaaaaaaaaaaaaaaaa
aaaaaaaaaaaaaaaaaaaaaaaaaaaaaaaaaaabaeafacagahaiadaaaaaaaaaaaaaaaaaaaaaaaaaaaaaaaaaaaaaaaaaaaaaaaaaa
aaaaaaaaaaaaaaaaaaaaaaaaaaaaaaaaaaabajakalamakanadaaaaaaaaaaaaaaaaaaaaaaaaaaaaaaaaaaaaaaaaaaaaaaaaaa
aaaaaaaaaaaaaaaaaaaaaaaaaaaaaaaaaaacaeakacamaoapadaaaaaaaaaaaaaaaaaaaaaaaaaaaaaaaaaaaaaaaaaaaaaaaaaa
aaaaaaaaaaaaaaaaaaaaaaaaaaaaaaaaaaabamakacanaqaradaaaaaaaaaaaaaaaaaaaaaaaaaaaaaaaaaaaaaaaaaaaaaaaaaa
aaaaaaaaaaaaaaaaaaaaaaaaaaaaaaaaaaacasakacamamatadaaaaaaaaaaaaaaaaaaaaaaaaaaaaaaaaaaaaaaaaaaaaaaaaaa
aaaaaaaaaaaaaaaaaaaaaaaaaaaaaaaaaaadacalacacacacadadadababababadadaaaaaaaaaaaaaaaaaaaaaaaaaaaaaaaaaa
aaaaaaaaaaaaaaaaaaaaaaaaaaaaaaaaaaadauamavawaxayazaAaBaeaCaDaEamadaaaaaaaaaaaaaaaaaaaaaaaaaaaaaaaaaa
aaaaaaaaaaaaaaaaaaaaaaaaaaaaaaaaaaadaFakakaGaHaIaJanamamaeacacaeadaaaaaaaaaaaaaaaaaaaaaaaaaaaaaaaaaa
aaaaaaaaaaaaaaaaaaadaKaLadabababababamamamamanaMaNaOaPamaQacacaRadadaaaaaaaaaaaaaaaaaaaaaaaaaaaaaaaa
aaaaaaaaaaaaaaaaaaadaKbdadababababaTamananaHanaSaUaVaWakamamaeamaeadaaaaaaaaaaaaaaaaaaaaaaaaaaaaaaaa
aaaaaaaaaaaaaaaaaaadaKbnadababaDaeaeaeaHaXaYanaSaUaZaWakbabbaHanbcadaaaaaaaaaaaaaaaaaaaaaaaaaaaaaaaa
aaaaaaaaaaaaaaaaaaadaKbuadababbebfamambgacacbhaMbibjbkblblblblblbmadaaaaaaaaaaaaaaaaaaaaaaaaaaaaaaaa
aaaaaaaaaaaaaaaaaaadaKbzadabboaeaebpaHanacacbhaSamanbAbqbrblakbsbtadaaaaaaaaaaaaaaaaaaaaaaaaaaaaaaaa
aaaaaaaaaaaaaaaaaaadaKbFadabbeaeaDbvanblblbwbxbybGbMckcrcsbBbBbCbDadaaaaaaaaaaaaaaaaaaaaaaaaaaaaaaaa
aaaaaaaaaaaaaaaaaaadaKbdadababababaeamblacacbEaccJacadadcNadadadadadaaaaaaaaaaaaaaaaaaaaaaaaaaaaaaaa
aaaaaaaaaaaaaaaaaaadaKcRadabababadalbIbJacananancSbKadbLcTbNbObPbQadaaaaaaaaaaaaaaaaaaaaaaaaaaaaaaaa
aaaaaaaaaaaaaaaaaaadaKcRadabababadbRaMblacblbqbScSbTadbUcUbWbObXbYadaaaaaaaaaaaaaaaaaaaaaaaaaaaaaaaa
aaaaaaaaaaaaaaaaaaadaKbdadabababadbZcaaWaccbbqcccVanadbUcWbAcdbVceadaaaaaaaaaaaaaaaaaaaaaaaaaaaaaaaa
aaaaaaaaaaaaaaaaaaadaKbdadabababadcfcgchaccibBcjcXaHadbLclcmadcncoadaaaaaaaaaaaaaaaaaaaaaaaaaaaaaaaa
aaaaaaaaaaaaaaaaadadcpcRadadadadadadadadadadcqadcYadadadadadadadadadaaaaaaaaaaaaaaaaaaaaaaaaaaaaaaaa
aaaaaaaaaaaaaaaacZdadbdcdddecZdbdfdfdadadadbdadbdgdbdacZcZdbdhdfdadiaaaaaaaaaaaaaaaaaaaaaaaaaaaaaaaa
aaaaaaaaaaaaaaaactctctctctctctctctctcubHcvcwcxamcyczcAbHcBcucRcBctctaaaaaaaaaaaaaaaaaaaaaaaaaaaaaaaa
aaaaaaaaaaaaaaaaadadadadadadadadadadadcCaScDcEakcFcpaScCadadcNadadadaaaaaaaaaaaaaaaaaaaaaaaaaaaaaaaa
aaaaaaaaaaaaaaaaaaaaaaaaaaaaaaaaaaaaadadaSbHaScGaScHaMadadcIdjcKadaaaaaaaaaaaaaaaaaaaaaaaaaaaaaaaaaa
aaaaaaaaaaaaaaaaaaaaaaaaaaaaaaaaaaaaaaadadadadadadadadadcLaMbncMadaaaaaaaaaaaaaaaaaaaaaaaaaaaaaaaaaa
aaaaaaaaaaaaaaaaaaaaaaaaaaaaaaaaaaaaaaaaaaaaaaaaaaaaaaadcMdkdlcMadaaaaaaaaaaaaaaaaaaaaaaaaaaaaaaaaaa
aaaaaaaaaaaaaaaaaaaaaaaaaaaaaaaaaaaaaaaaaaaaaaaaaaaaaaadcOdmcPcQadaaaaaaaaaaaaaaaaaaaaaaaaaaaaaaaaaa
aaaaaaaaaaaaaaaaaaaaaaaaaaaaaaaaaaaaaaaaaaaaaaaaaaaaaaadadadadadadaaaaaaaaaaaaaaaaaaaaaaaaaaaaaaaaaa
aaaaaaaaaaaaaaaaaaaaaaaaaaaaaaaaaaaaaaaaaaaaaaaaaaaaaaaaaaaaaaaaaaaaaaaaaaaaaaaaaaaaaaaaaaaaaaaaaaaa
aaaaaaaaaaaaaaaaaaaaaaaaaaaaaaaaaaaaaaaaaaaaaaaaaaaaaaaaaaaaaaaaaaaaaaaaaaaaaaaaaaaaaaaaaaaaaaaaaaaa
aaaaaaaaaaaaaaaaaaaaaaaaaaaaaaaaaaaaaaaaaaaaaaaaaaaaaaaaaaaaaaaaaaaaaaaaaaaaaaaaaaaaaaaaaaaaaaaaaaaa
aaaaaaaaaaaaaaaaaaaaaaaaaaaaaaaaaaaaaaaaaaaaaaaaaaaaaaaaaaaaaaaaaaaaaaaaaaaaaaaaaaaaaaaaaaaaaaaaaaaa
aaaaaaaaaaaaaaaaaaaaaaaaaaaaaaaaaaaaaaaaaaaaaaaaaaaaaaaaaaaaaaaaaaaaaaaaaaaaaaaaaaaaaaaaaaaaaaaaaaaa
aaaaaaaaaaaaaaaaaaaaaaaaaaaaaaaaaaaaaaaaaaaaaaaaaaaaaaaaaaaaaaaaaaaaaaaaaaaaaaaaaaaaaaaaaaaaaaaaaaaa
aaaaaaaaaaaaaaaaaaaaaaaaaaaaaaaaaaaaaaaaaaaaaaaaaaaaaaaaaaaaaaaaaaaaaaaaaaaaaaaaaaaaaaaaaaaaaaaaaaaa
aaaaaaaaaaaaaaaaaaaaaaaaaaaaaaaaaaaaaaaaaaaaaaaaaaaaaaaaaaaaaaaaaaaaaaaaaaaaaaaaaaaaaaaaaaaaaaaaaaaa
aaaaaaaaaaaaaaaaaaaaaaaaaaaaaaaaaaaaaaaaaaaaaaaaaaaaaaaaaaaaaaaaaaaaaaaaaaaaaaaaaaaaaaaaaaaaaaaaaaaa
aaaaaaaaaaaaaaaaaaaaaaaaaaaaaaaaaaaaaaaaaaaaaaaaaaaaaaaaaaaaaaaaaaaaaaaaaaaaaaaaaaaaaaaaaaaaaaaaaaaa
aaaaaaaaaaaaaaaaaaaaaaaaaaaaaaaaaaaaaaaaaaaaaaaaaaaaaaaaaaaaaaaaaaaaaaaaaaaaaaaaaaaaaaaaaaaaaaaaaaaa
aaaaaaaaaaaaaaaaaaaaaaaaaaaaaaaaaaaaaaaaaaaaaaaaaaaaaaaaaaaaaaaaaaaaaaaaaaaaaaaaaaaaaaaaaaaaaaaaaaaa
aaaaaaaaaaaaaaaaaaaaaaaaaaaaaaaaaaaaaaaaaaaaaaaaaaaaaaaaaaaaaaaaaaaaaaaaaaaaaaaaaaaaaaaaaaaaaaaaaaaa
"}
